Customer ID,Recency,Frequency,Monetary,R,F,M,Total_Score,Segment
AA-10315,185,5,5563.56,1,1,3,5,About to Sleep
AA-10375,20,9,1056.39,3,3,1,7,Potential Loyalist
AA-10480,260,4,1790.5120000000002,1,1,2,4,About to Sleep
AA-10645,56,6,5086.9349999999995,2,2,3,7,Others
AB-10015,416,3,886.156,1,1,1,3,Lost Customer
AB-10060,55,8,7755.62,2,3,3,8,Loyal
AB-10105,42,10,14473.570999999998,3,3,3,9,Champion
AB-10150,42,5,966.71,3,1,1,5,About to Sleep
AB-10165,26,8,1113.838,3,3,1,7,Potential Loyalist
AB-10255,167,9,914.5319999999999,1,3,1,5,About to Sleep
AB-10600,51,4,1515.862,2,1,2,5,About to Sleep
AC-10420,233,3,925.8,1,1,1,3,Lost Customer
AC-10450,12,7,5527.846,3,2,3,8,Loyal
AC-10615,7,5,2537.6859999999997,3,1,2,6,Recent Customer
AC-10660,283,5,657.316,1,1,1,3,Lost Customer
AD-10180,30,8,6106.88,3,3,3,9,Champion
AF-10870,42,7,2052.908,3,2,2,7,Potential Loyalist
AF-10885,416,4,861.565,1,1,1,3,Lost Customer
AG-10270,279,5,2582.898,1,1,2,4,About to Sleep
AG-10300,119,4,367.548,2,1,1,4,About to Sleep
AG-10330,9,5,660.972,3,1,1,5,About to Sleep
AG-10390,115,5,200.945,2,1,1,4,About to Sleep
AG-10495,79,8,2356.855,2,3,2,7,Others
AG-10525,846,4,1455.038,1,1,1,3,Lost Customer
AG-10675,98,7,3489.0396000000005,2,2,3,7,Others
AG-10765,78,4,170.584,2,1,1,4,About to Sleep
AG-10900,97,10,4510.797,2,3,3,8,Loyal
AH-10030,13,7,1744.7,3,2,2,7,Potential Loyalist
AH-10075,35,10,3250.337,3,3,3,9,Champion
AH-10120,61,7,1735.5140000000001,2,2,2,6,Average
AH-10195,56,4,1587.452,2,1,2,5,About to Sleep
AH-10210,7,9,4805.344,3,3,3,9,Champion
AH-10465,231,5,2495.3916,1,1,2,4,About to Sleep
AH-10585,22,4,738.504,3,1,1,5,About to Sleep
AH-10690,411,12,7888.294,1,3,3,7,Cannot Lose Them
AI-10855,14,10,4375.786,3,3,3,9,Champion
AJ-10780,76,7,4867.344,2,2,3,7,Others
AJ-10795,167,7,4501.391,1,2,3,6,Average
AJ-10945,86,7,1839.24,2,2,2,6,Average
AJ-10960,75,3,629.2479999999999,2,1,1,4,About to Sleep
AM-10360,29,5,814.012,3,1,1,5,About to Sleep
AM-10705,163,8,5664.022,1,3,3,7,Cannot Lose Them
AO-10810,502,1,161.28,1,1,1,3,Lost Customer
AP-10720,42,8,1638.554,3,3,2,8,Loyal
AP-10915,99,10,3323.556,2,3,3,8,Loyal
AR-10345,112,4,1055.694,2,1,1,4,About to Sleep
AR-10405,126,5,2236.128,1,1,2,4,About to Sleep
AR-10510,15,5,264.86400000000003,3,1,1,5,About to Sleep
AR-10540,7,6,6608.448,3,2,3,8,Loyal
AR-10570,535,1,88.15,1,1,1,3,Lost Customer
AR-10825,59,8,4523.336,2,3,3,8,Loyal
AS-10045,89,7,3050.692,2,2,2,6,Average
AS-10090,29,9,3255.31,3,3,3,9,Champion
AS-10135,42,2,58.82,3,1,1,5,About to Sleep
AS-10225,23,5,4260.784,3,1,3,7,Potential Loyalist
AS-10240,193,7,584.6080000000001,1,2,1,4,About to Sleep
AS-10285,20,6,3214.236,3,2,3,8,Loyal
AS-10630,93,7,833.398,2,2,1,5,About to Sleep
AT-10435,22,6,1171.814,3,2,1,6,Recent Customer
AT-10735,14,10,3831.864,3,3,3,9,Champion
AW-10840,21,4,649.376,3,1,1,5,About to Sleep
AW-10930,47,7,2852.968,2,2,2,6,Average
AY-10555,15,4,497.014,3,1,1,5,About to Sleep
AZ-10750,161,6,1622.0179999999998,1,2,2,5,About to Sleep
BB-10990,106,5,744.3399999999999,2,1,1,4,About to Sleep
BB-11545,29,9,6765.728,3,3,3,9,Champion
BC-11125,203,9,2933.676,1,3,2,6,Average
BD-11320,34,12,5718.521,3,3,3,9,Champion
BD-11500,36,6,4411.2429999999995,3,2,3,8,Loyal
BD-11560,279,2,320.54,1,1,1,3,Lost Customer
BD-11605,98,7,3288.471,2,2,3,7,Others
BD-11620,70,6,1538.11,2,2,2,6,Average
BD-11635,10,3,582.646,3,1,1,5,About to Sleep
BD-11725,94,6,1526.5,2,2,2,6,Average
BD-11770,328,6,658.466,1,2,1,4,About to Sleep
BE-11335,120,5,4204.676,2,1,3,6,Average
BE-11410,99,5,2261.438,2,1,2,5,About to Sleep
BE-11455,255,6,1727.652,1,2,2,5,About to Sleep
BF-10975,92,7,599.798,2,2,1,5,About to Sleep
BF-11005,40,4,1333.88,3,1,1,5,About to Sleep
BF-11020,75,8,2888.506,2,3,2,7,Others
BF-11080,26,3,272.95,3,1,1,5,About to Sleep
BF-11170,17,11,5907.972,3,3,3,9,Champion
BF-11215,66,4,1585.162,2,1,2,5,About to Sleep
BF-11275,58,3,791.9899999999999,2,1,1,4,About to Sleep
BG-11035,29,8,2798.948,3,3,2,8,Loyal
BG-11695,37,6,1874.172,3,2,2,7,Potential Loyalist
BG-11740,58,6,1006.356,2,2,1,5,About to Sleep
BH-11710,24,8,6255.351,3,3,3,9,Champion
BK-11260,78,6,659.1379999999999,2,2,1,5,About to Sleep
BM-11140,308,4,11789.63,1,1,3,5,About to Sleep
BM-11575,101,6,808.162,2,2,1,5,About to Sleep
BM-11650,34,11,7294.185,3,3,3,9,Champion
BM-11785,219,10,1338.842,1,3,1,5,About to Sleep
BN-11470,25,4,265.296,3,1,1,5,About to Sleep
BN-11515,10,5,1459.344,3,1,2,6,Recent Customer
BO-11350,138,5,2682.728,1,1,2,4,About to Sleep
BO-11425,76,2,130.83,2,1,1,4,About to Sleep
BP-11050,84,5,983.42,2,1,1,4,About to Sleep
BP-11095,18,12,2442.044,3,3,2,8,Loyal
BP-11155,90,6,1697.8609999999999,2,2,2,6,Average
BP-11185,2,9,3675.861,3,3,3,9,Champion
BP-11230,40,5,1181.49,3,1,1,5,About to Sleep
BP-11290,13,7,2475.157,3,2,2,7,Potential Loyalist
BS-11365,559,5,10501.653,1,1,3,5,About to Sleep
BS-11380,29,5,3887.834,3,1,3,7,Potential Loyalist
BS-11590,36,6,2454.928,3,2,2,7,Potential Loyalist
BS-11665,583,3,3288.1099999999997,1,1,3,5,About to Sleep
BS-11755,2,7,2562.382,3,2,2,7,Potential Loyalist
BS-11800,266,2,949.4300000000001,1,1,1,3,Lost Customer
BT-11305,337,5,2567.656,1,1,2,4,About to Sleep
BT-11395,303,6,2186.6130000000003,1,2,2,5,About to Sleep
BT-11440,561,4,603.876,1,1,1,3,Lost Customer
BT-11485,660,2,415.19599999999997,1,1,1,3,Lost Customer
BT-11530,92,5,2684.4919999999997,2,1,2,5,About to Sleep
BT-11680,21,7,3196.752,3,2,3,8,Loyal
BV-11245,335,5,1523.2730000000001,1,1,2,4,About to Sleep
BW-11065,213,3,385.516,1,1,1,3,Lost Customer
BW-11110,122,8,4750.358,1,3,3,7,Cannot Lose Them
BW-11200,204,6,1738.406,1,2,2,5,About to Sleep
CA-11965,97,6,3789.7228,2,2,3,7,Others
CA-12055,402,5,1679.7240000000002,1,1,2,4,About to Sleep
CA-12265,57,9,2648.2872,2,3,2,7,Others
CA-12310,14,4,1421.954,3,1,1,5,About to Sleep
CA-12775,121,7,3041.566,2,2,2,6,Average
CB-12025,48,10,6076.139,2,3,3,8,Loyal
CB-12415,27,8,1949.2,3,3,2,8,Loyal
CB-12535,198,8,4246.4555,1,3,3,7,Cannot Lose Them
CC-12100,458,6,1770.945,1,2,2,5,About to Sleep
CC-12145,107,7,2471.65,2,2,2,6,Average
CC-12220,21,12,3913.418,3,3,3,9,Champion
CC-12370,44,5,12129.072000000002,2,1,3,6,Average
CC-12430,1,10,2870.05,3,3,2,8,Loyal
CC-12475,40,9,1659.438,3,3,2,8,Loyal
CC-12550,28,3,113.832,3,1,1,5,About to Sleep
CC-12610,35,7,2540.631,3,2,2,7,Potential Loyalist
CC-12670,30,7,2269.7015,3,2,2,7,Potential Loyalist
CC-12685,800,4,2854.1150000000002,1,1,2,4,About to Sleep
CD-11920,41,5,2033.968,3,1,2,6,Recent Customer
CD-11980,55,3,639.766,2,1,1,4,About to Sleep
CD-12280,43,2,1205.584,2,1,1,4,About to Sleep
CD-12790,400,5,1860.732,1,1,2,4,About to Sleep
CG-12040,50,6,904.4680000000001,2,2,1,5,About to Sleep
CG-12520,339,3,1148.7800000000002,1,1,1,3,Lost Customer
CH-12070,692,3,1537.236,1,1,2,4,About to Sleep
CJ-11875,366,1,16.52,1,1,1,3,Lost Customer
CJ-12010,190,8,11164.974,1,3,3,7,Cannot Lose Them
CK-12205,40,13,3154.855,3,3,3,9,Champion
CK-12325,121,5,2945.321,2,1,2,5,About to Sleep
CK-12595,44,11,2372.75,2,3,2,7,Others
CK-12760,83,9,1582.109,2,3,2,7,Others
CL-11890,107,4,1262.0140000000001,2,1,1,4,About to Sleep
CL-12565,285,12,10880.546,1,3,3,7,Cannot Lose Them
CL-12700,106,5,2353.586,2,1,2,5,About to Sleep
CM-11815,132,6,1673.888,1,2,2,5,About to Sleep
CM-11935,709,2,565.392,1,1,1,3,Lost Customer
CM-12115,9,4,1661.6100000000001,3,1,2,6,Recent Customer
CM-12160,27,6,2533.314,3,2,2,7,Potential Loyalist
CM-12190,9,6,1475.144,3,2,2,7,Potential Loyalist
CM-12235,386,5,2305.712,1,1,2,4,About to Sleep
CM-12385,38,4,8954.019999999999,3,1,3,7,Potential Loyalist
CM-12445,437,3,287.99,1,1,1,3,Lost Customer
CM-12655,28,6,6339.5576,3,2,3,8,Loyal
CM-12715,1036,4,3984.4524,1,1,3,5,About to Sleep
CP-12085,83,8,5402.254,2,3,3,8,Loyal
CP-12340,161,8,5888.275,1,3,3,7,Cannot Lose Them
CR-12580,58,4,2148.852,2,1,2,5,About to Sleep
CR-12625,471,3,475.9,1,1,1,3,Lost Customer
CR-12730,79,4,1600.55,2,1,2,5,About to Sleep
CR-12820,86,3,1397.8724,2,1,1,4,About to Sleep
CS-11845,92,5,1278.954,2,1,1,4,About to Sleep
CS-11860,163,6,537.632,1,2,1,4,About to Sleep
CS-11950,26,11,3036.547,3,3,2,8,Loyal
CS-12130,490,4,884.64,1,1,1,3,Lost Customer
CS-12175,233,5,844.4580000000001,1,1,1,3,Lost Customer
CS-12250,27,12,2754.216,3,3,2,8,Loyal
CS-12355,7,11,3202.1620000000003,3,3,3,9,Champion
CS-12400,3,9,3651.8585000000003,3,3,3,9,Champion
CS-12460,28,2,550.644,3,1,1,5,About to Sleep
CS-12490,425,4,1077.2285,1,1,1,3,Lost Customer
CS-12505,59,6,5690.054999999999,2,2,3,7,Others
CT-11995,97,8,3241.898,2,3,3,8,Loyal
CV-12295,255,5,2830.6279999999997,1,1,2,4,About to Sleep
CV-12805,6,9,2370.3136,3,3,2,8,Loyal
CW-11905,23,6,1136.592,3,2,1,6,Recent Customer
CY-12745,61,8,2900.026,2,3,2,7,Others
Co-12640,550,5,1300.076,1,1,1,3,Lost Customer
DA-13450,353,4,156.76,1,1,1,3,Lost Customer
DB-12910,22,8,2171.599,3,3,2,8,Loyal
DB-12970,242,5,2839.2272,1,1,2,4,About to Sleep
DB-13060,17,7,4531.646,3,2,3,8,Loyal
DB-13120,49,7,2973.094,2,2,2,6,Average
DB-13210,10,10,2332.577,3,3,2,8,Loyal
DB-13270,54,8,4655.897,2,3,3,8,Loyal
DB-13360,265,5,1081.466,1,1,1,3,Lost Customer
DB-13405,188,4,1711.692,1,1,2,4,About to Sleep
DB-13555,108,7,3908.8028,2,2,3,7,Others
DB-13615,34,7,1989.05,3,2,2,7,Potential Loyalist
DB-13660,13,7,1155.202,3,2,1,6,Recent Customer
DC-12850,38,9,3336.168,3,3,3,9,Champion
DC-13285,24,5,1174.618,3,1,1,5,About to Sleep
DD-13570,42,6,269.542,3,2,1,6,Recent Customer
DE-13255,720,5,2550.874,1,1,2,4,About to Sleep
DF-13135,701,3,2390.534,1,1,2,4,About to Sleep
DG-13300,33,5,3195.818,3,1,3,7,Potential Loyalist
DH-13075,278,6,4932.872,1,2,3,6,Average
DH-13675,777,4,1043.096,1,1,1,3,Lost Customer
DJ-13420,638,4,2012.52,1,1,2,4,About to Sleep
DJ-13510,49,8,2501.6879999999996,2,3,2,7,Others
DJ-13630,13,3,3356.398,3,1,3,7,Potential Loyalist
DK-12835,22,12,3256.48,3,3,3,9,Champion
DK-12895,46,5,4282.176,2,1,3,6,Average
DK-12985,8,5,1687.04,3,1,2,6,Recent Customer
DK-13090,43,7,2650.557,2,2,2,6,Average
DK-13150,11,2,797.832,3,1,1,5,About to Sleep
DK-13225,11,9,4802.394,3,3,3,9,Champion
DK-13375,20,8,3318.486,3,3,3,9,Champion
DL-12865,101,8,1503.112,2,3,2,7,Others
DL-12925,58,6,3272.2,2,2,3,7,Others
DL-13315,23,8,1458.258,3,3,2,8,Loyal
DL-13330,58,4,585.02,2,1,1,4,About to Sleep
DL-13495,77,8,3539.322,2,3,3,8,Loyal
DM-12955,115,7,1322.034,2,2,1,5,About to Sleep
DM-13015,58,7,6345.103,2,2,3,7,Others
DM-13345,23,8,4074.4719999999998,3,3,3,9,Champion
DM-13525,482,3,1376.792,1,1,1,3,Lost Customer
DN-13690,218,7,2139.79,1,2,2,5,About to Sleep
DO-13435,134,9,1300.0315,1,3,1,5,About to Sleep
DO-13645,27,7,1267.316,3,2,1,6,Recent Customer
DP-13000,127,9,1050.636,1,3,1,5,About to Sleep
DP-13105,7,8,2215.002,3,3,2,8,Loyal
DP-13165,813,2,1058.616,1,1,1,3,Lost Customer
DP-13390,359,9,5480.723999999999,1,3,3,7,Cannot Lose Them
DR-12880,4,9,6528.034000000001,3,3,3,9,Champion
DR-12940,51,8,8350.868,2,3,3,8,Loyal
DS-13030,94,4,1762.213,2,1,2,5,About to Sleep
DS-13180,24,9,2881.8128,3,3,2,8,Loyal
DV-13045,20,5,1119.483,3,1,1,5,About to Sleep
DV-13465,30,6,3341.587,3,2,3,8,Loyal
DW-13195,70,6,1080.751,2,2,1,5,About to Sleep
DW-13480,218,5,5271.628,1,1,3,5,About to Sleep
DW-13540,99,5,344.08,2,1,1,4,About to Sleep
DW-13585,243,7,1204.854,1,2,1,4,About to Sleep
Dl-13600,120,5,755.602,2,1,1,4,About to Sleep
Dp-13240,85,11,7198.7609999999995,2,3,3,8,Loyal
EA-14035,153,13,2846.705,1,3,2,6,Average
EB-13705,49,9,3644.978,2,3,3,8,Loyal
EB-13750,36,10,3236.314,3,3,3,9,Champion
EB-13840,91,5,4358.128,2,1,3,6,Average
EB-13870,101,10,2767.219,2,3,2,7,Others
EB-13930,162,5,944.6000000000001,1,1,1,3,Lost Customer
EB-13975,1,4,1643.255,3,1,2,6,Recent Customer
EB-14110,114,6,3071.126,2,2,2,6,Average
EB-14170,83,6,1186.326,2,2,1,5,About to Sleep
EC-14050,54,5,461.914,2,1,1,4,About to Sleep
ED-13885,136,8,3484.92,1,3,3,7,Cannot Lose Them
EG-13900,23,5,1832.02,3,1,2,6,Recent Customer
EH-13765,136,12,10310.880000000001,1,3,3,7,Cannot Lose Them
EH-13945,218,8,684.1709999999999,1,3,1,5,About to Sleep
EH-13990,406,6,825.9499999999999,1,2,1,4,About to Sleep
EH-14005,3,7,1219.53,3,2,1,6,Recent Customer
EH-14125,153,10,3082.653,1,3,2,6,Average
EH-14185,106,6,923.884,2,2,1,5,About to Sleep
EJ-13720,303,4,2162.174,1,1,2,4,About to Sleep
EJ-14155,58,5,2656.691,2,1,2,5,About to Sleep
EK-13795,45,4,1303.478,2,1,1,4,About to Sleep
EL-13735,78,2,124.28,2,1,1,4,About to Sleep
EM-13810,133,5,2567.0099999999998,1,1,2,4,About to Sleep
EM-13825,56,8,2339.598,2,3,2,7,Others
EM-13960,152,5,933.704,1,1,1,3,Lost Customer
EM-14065,48,4,228.99,2,1,1,4,About to Sleep
EM-14095,114,4,1041.0420000000001,2,1,1,4,About to Sleep
EM-14140,49,6,4588.436000000001,2,2,3,7,Others
EM-14200,159,3,366.822,1,1,1,3,Lost Customer
EN-13780,288,4,2199.366,1,1,2,4,About to Sleep
EP-13915,13,17,5478.0608,3,3,3,9,Champion
ER-13855,422,3,1245.788,1,1,1,3,Lost Customer
ES-14020,41,5,3510.4579999999996,3,1,3,7,Potential Loyalist
ES-14080,29,9,4657.924,3,3,3,9,Champion
FA-14230,98,7,2984.054,2,2,2,6,Average
FC-14245,71,7,3418.742,2,2,3,7,Others
FC-14335,185,7,3889.366,1,2,3,6,Average
FG-14260,35,7,1383.144,3,2,1,6,Recent Customer
FH-14275,38,10,4256.272,3,3,3,9,Champion
FH-14350,213,4,2271.284,1,1,2,4,About to Sleep
FH-14365,6,8,6987.196,3,3,3,9,Champion
FM-14215,8,10,2456.638,3,3,2,8,Loyal
FM-14290,37,9,3736.198,3,3,3,9,Champion
FM-14380,146,9,2523.266,1,3,2,6,Average
FO-14305,39,10,2678.438,3,3,2,8,Loyal
FP-14320,24,8,4046.746,3,3,3,9,Champion
FW-14395,363,3,79.75,1,1,1,3,Lost Customer
GA-14515,150,8,3919.7760000000003,1,3,3,7,Cannot Lose Them
GA-14725,6,11,1398.382,3,3,1,7,Potential Loyalist
GB-14530,63,11,1568.44,2,3,2,7,Others
GB-14575,14,5,4716.288,3,1,3,7,Potential Loyalist
GD-14590,6,4,1888.07,3,1,2,6,Recent Customer
GG-14650,44,9,2224.0,2,3,2,7,Others
GH-14410,76,9,2819.4669999999996,2,3,2,7,Others
GH-14425,51,4,4172.8460000000005,2,1,3,6,Average
GH-14485,388,2,1361.2440000000001,1,1,1,3,Lost Customer
GH-14665,3,2,146.94080000000002,3,1,1,5,About to Sleep
GK-14620,113,9,6497.27,2,3,3,8,Loyal
GM-14440,84,7,3582.8199999999997,2,2,3,7,Others
GM-14455,17,6,3078.624,3,2,2,7,Potential Loyalist
GM-14500,107,10,1255.682,2,3,1,6,Average
GM-14680,153,6,3163.628,1,2,3,6,Average
GM-14695,118,3,6049.966,2,1,3,6,Average
GP-14740,766,2,236.53,1,1,1,3,Lost Customer
GR-14560,1136,2,1284.38,1,1,1,3,Lost Customer
GT-14635,57,3,9351.212,2,1,3,6,Average
GT-14710,37,11,11820.119999999999,3,3,3,9,Champion
GT-14755,35,4,226.436,3,1,1,5,About to Sleep
GW-14605,29,7,2189.019,3,2,2,7,Potential Loyalist
GZ-14470,8,9,4355.150000000001,3,3,3,9,Champion
GZ-14545,158,4,2454.6220000000003,1,1,2,4,About to Sleep
HA-14905,70,7,2163.3,2,2,2,6,Average
HA-14920,21,8,2584.158,3,3,2,8,Loyal
HD-14785,770,3,251.36,1,1,1,3,Lost Customer
HE-14800,13,4,883.5319999999999,3,1,1,5,About to Sleep
HF-14995,22,7,2533.1639999999998,3,2,2,7,Potential Loyalist
HG-14845,55,5,785.628,2,1,1,4,About to Sleep
HG-14965,24,12,3247.642,3,3,3,9,Champion
HG-15025,7,7,3690.284,3,2,3,8,Loyal
HH-15010,73,2,218.668,2,1,1,4,About to Sleep
HJ-14875,127,5,358.1,1,1,1,3,Lost Customer
HK-14890,152,8,4877.784,1,3,3,7,Cannot Lose Them
HL-15040,44,6,12873.297999999999,2,2,3,7,Others
HM-14860,3,10,8236.7648,3,3,3,9,Champion
HM-14980,248,4,736.276,1,1,1,3,Lost Customer
HP-14815,31,7,1990.314,3,2,2,7,Potential Loyalist
HR-14770,14,5,1299.288,3,1,1,5,About to Sleep
HR-14830,160,7,5248.787,1,2,3,6,Average
HW-14935,118,8,9300.254,2,3,3,8,Loyal
HZ-14950,36,5,886.52,3,1,1,5,About to Sleep
IG-15085,72,4,744.574,2,1,1,4,About to Sleep
IL-15100,143,7,5040.736,1,2,3,6,Average
IM-15055,410,3,2872.63,1,1,2,4,About to Sleep
IM-15070,391,7,4930.474,1,2,3,6,Average
JA-15970,93,8,6491.026,2,3,3,8,Loyal
JB-15400,8,10,1791.605,3,3,2,8,Loyal
JB-15925,738,3,900.552,1,1,1,3,Lost Customer
JB-16000,44,7,644.1188,2,2,1,5,About to Sleep
JB-16045,8,5,2518.115,3,1,2,6,Recent Customer
JC-15340,115,4,71.263,2,1,1,4,About to Sleep
JC-15385,176,1,1058.108,1,1,1,3,Lost Customer
JC-15775,159,9,2772.055,1,3,2,6,Average
JC-16105,58,5,858.576,2,1,1,4,About to Sleep
JD-15790,118,5,2152.352,2,1,2,5,About to Sleep
JD-15895,395,11,7610.8640000000005,1,3,3,7,Cannot Lose Them
JD-16015,113,6,385.43,2,2,1,5,About to Sleep
JD-16060,301,3,695.442,1,1,1,3,Lost Customer
JD-16150,42,8,8828.0305,3,3,3,9,Champion
JE-15475,194,6,1388.682,1,2,1,4,About to Sleep
JE-15610,49,7,7754.976,2,2,3,7,Others
JE-15715,47,10,8697.842999999999,2,3,3,8,Loyal
JE-15745,52,13,6760.8150000000005,2,3,3,8,Loyal
JE-16165,21,3,2697.248,3,1,2,6,Recent Customer
JF-15190,66,7,2279.5860000000002,2,2,2,6,Average
JF-15295,226,5,955.124,1,1,1,3,Lost Customer
JF-15355,106,6,1911.844,2,2,2,6,Average
JF-15415,3,6,2371.448,3,2,2,7,Potential Loyalist
JF-15490,122,11,1082.918,1,3,1,5,About to Sleep
JF-15565,55,8,4198.332,2,3,3,8,Loyal
JG-15115,759,3,2358.676,1,1,2,4,About to Sleep
JG-15160,2,11,6366.392,3,3,3,9,Champion
JG-15310,3,6,2240.58,3,2,2,7,Potential Loyalist
JG-15805,224,6,1507.018,1,2,2,5,About to Sleep
JH-15430,6,4,309.281,3,1,1,5,About to Sleep
JH-15820,175,6,528.91,1,2,1,4,About to Sleep
JH-15910,42,7,959.477,3,2,1,6,Recent Customer
JH-15985,30,6,7954.9980000000005,3,2,3,8,Loyal
JH-16180,405,4,2256.3940000000002,1,1,2,4,About to Sleep
JJ-15445,484,5,709.178,1,1,1,3,Lost Customer
JJ-15760,754,2,195.0,1,1,1,3,Lost Customer
JK-15205,62,5,4427.142,2,1,3,6,Average
JK-15325,288,3,383.812,1,1,1,3,Lost Customer
JK-15370,45,8,2709.632,2,3,2,7,Others
JK-15625,62,7,3760.028,2,2,3,7,Others
JK-15640,181,9,4760.434,1,3,3,7,Cannot Lose Them
JK-15730,85,10,4867.2,2,3,3,8,Loyal
JK-16090,29,3,3747.668,3,1,3,7,Potential Loyalist
JK-16120,118,10,2932.484,2,3,2,7,Others
JL-15130,9,6,1214.956,3,2,1,6,Recent Customer
JL-15175,7,5,1571.523,3,1,2,6,Recent Customer
JL-15235,120,5,2203.7,2,1,2,5,About to Sleep
JL-15505,50,6,3173.874,2,2,3,7,Others
JL-15835,22,11,9799.923,3,3,3,9,Champion
JL-15850,615,6,2725.256,1,2,2,5,About to Sleep
JM-15250,38,6,3159.1220000000003,3,2,3,8,Loyal
JM-15265,38,5,1804.146,3,1,2,6,Recent Customer
JM-15535,103,7,1733.443,2,2,2,6,Average
JM-15580,1,5,303.948,3,1,1,5,About to Sleep
JM-15655,9,5,864.947,3,2,1,6,Recent Customer
JM-15865,110,7,7625.076000000001,2,2,3,7,Others
JM-16195,58,10,2833.9260000000004,2,3,2,7,Others
JO-15145,58,9,3254.949,2,3,3,8,Loyal
JO-15280,93,6,1934.272,2,2,2,6,Average
JO-15550,216,5,1090.838,1,2,1,4,About to Sleep
JP-15460,38,7,1669.135,3,2,2,7,Potential Loyalist
JP-15520,9,7,3635.594,3,2,3,8,Loyal
JP-16135,103,9,1707.71,2,3,2,7,Others
JR-15670,594,2,1156.658,1,1,1,3,Lost Customer
JR-15700,69,1,863.88,2,1,1,4,About to Sleep
JR-16210,34,5,2201.686,3,2,2,7,Potential Loyalist
JS-15595,120,4,1417.654,2,1,1,4,About to Sleep
JS-15685,43,4,1131.0639999999999,2,1,1,4,About to Sleep
JS-15880,535,5,3868.02,1,2,3,6,Average
JS-15940,464,5,469.169,1,2,1,4,About to Sleep
JS-16030,29,6,2516.494,3,2,2,7,Potential Loyalist
JW-15220,43,6,7721.714,2,2,3,7,Others
JW-15955,6,7,1244.086,3,2,1,6,Recent Customer
JW-16075,462,4,1428.731,1,1,1,3,Lost Customer
KA-16525,37,7,1519.506,3,2,2,7,Potential Loyalist
KB-16240,5,7,3152.6150000000002,3,2,3,8,Loyal
KB-16315,297,9,1569.464,1,3,2,6,Average
KB-16405,118,3,908.821,2,1,1,4,About to Sleep
KB-16585,231,12,2744.742,1,3,2,6,Average
KB-16600,2,7,983.922,3,2,1,6,Recent Customer
KC-16255,408,6,2120.954,1,2,2,5,About to Sleep
KC-16540,98,4,3908.262,2,1,3,6,Average
KC-16675,58,4,1146.05,2,1,1,4,About to Sleep
KD-16270,485,5,8282.358,1,2,3,6,Average
KD-16345,42,6,1888.964,3,2,2,7,Potential Loyalist
KD-16495,113,12,8181.256,2,3,3,8,Loyal
KD-16615,290,5,2243.5099999999998,1,2,2,5,About to Sleep
KE-16420,27,8,1686.7312,3,3,2,8,Loyal
KF-16285,98,7,10604.266,2,2,3,7,Others
KH-16330,41,8,3312.864,3,3,3,9,Champion
KH-16360,2,6,3100.612,3,2,2,7,Potential Loyalist
KH-16510,23,7,5952.859,3,2,3,8,Loyal
KH-16630,59,9,3918.9660000000003,2,3,3,8,Loyal
KH-16690,3,7,5990.799,3,2,3,8,Loyal
KL-16555,17,8,5016.488,3,3,3,9,Champion
KL-16645,48,12,14175.229000000001,2,3,3,8,Loyal
KM-16225,15,6,2260.958,3,2,2,7,Potential Loyalist
KM-16375,57,8,5620.186,2,3,3,8,Loyal
KM-16660,16,5,453.538,3,2,1,6,Recent Customer
KM-16720,29,8,4909.472,3,3,3,9,Champion
KN-16390,20,9,2617.272,3,3,2,8,Loyal
KN-16450,53,5,2171.962,2,2,2,6,Average
KN-16705,99,8,2280.58,2,3,2,7,Others
KS-16300,296,3,88.472,1,1,1,3,Lost Customer
KT-16465,392,7,3057.1,1,2,2,5,About to Sleep
KT-16480,101,10,4642.088400000001,2,3,3,8,Loyal
KW-16435,97,5,4416.5199999999995,2,2,3,7,Others
KW-16570,772,4,449.096,1,1,1,3,Lost Customer
LA-16780,155,11,8673.222,1,3,3,7,Cannot Lose Them
LB-16735,49,3,50.188,2,1,1,4,About to Sleep
LB-16795,153,8,4985.676,1,3,3,7,Cannot Lose Them
LC-16870,28,8,2580.7039999999997,3,3,2,8,Loyal
LC-16885,17,12,7663.126,3,3,3,9,Champion
LC-16930,42,8,4492.946,3,3,3,9,Champion
LC-16960,437,4,3246.626,1,1,3,5,About to Sleep
LC-17050,55,5,2095.064,2,2,2,6,Average
LC-17140,14,9,2633.582,3,3,2,8,Loyal
LD-16855,553,1,5.304,1,1,1,3,Lost Customer
LD-17005,415,4,1961.934,1,1,2,4,About to Sleep
LE-16810,22,6,1469.45,3,2,2,7,Potential Loyalist
LF-17185,23,7,3930.5089999999996,3,2,3,8,Loyal
LH-16750,152,3,287.426,1,1,1,3,Lost Customer
LH-16900,22,9,2295.332,3,3,2,8,Loyal
LH-17020,240,4,318.239,1,1,1,3,Lost Customer
LH-17155,386,9,1739.689,1,3,2,6,Average
LL-16840,250,6,2741.2039999999997,1,2,2,5,About to Sleep
LM-17065,392,5,1346.774,1,2,1,4,About to Sleep
LO-17170,3,5,644.35,3,2,1,6,Recent Customer
LP-17080,41,4,756.606,3,1,1,5,About to Sleep
LP-17095,10,7,3653.399,3,2,3,8,Loyal
LR-16915,27,6,5142.892,3,2,3,8,Loyal
LR-17035,133,5,1879.306,1,2,2,5,About to Sleep
LS-16945,179,6,2845.27,1,2,2,5,About to Sleep
LS-16975,21,9,2988.674,3,3,2,8,Loyal
LS-17200,97,6,1010.2560000000001,2,2,1,5,About to Sleep
LS-17230,778,3,368.88000000000005,1,1,1,3,Lost Customer
LS-17245,35,6,1008.1360000000001,3,2,1,6,Recent Customer
LT-16765,27,3,329.876,3,1,1,5,About to Sleep
LT-17110,35,8,2936.252,3,3,2,8,Loyal
LW-16825,89,5,2238.061,2,2,2,6,Average
LW-16990,34,6,3230.308,3,2,3,8,Loyal
LW-17125,206,3,1259.04,1,1,1,3,Lost Customer
LW-17215,22,7,5420.514,3,2,3,8,Loyal
MA-17560,65,11,4299.161,2,3,3,8,Loyal
MA-17995,187,6,2453.284,1,2,2,5,About to Sleep
MB-17305,49,10,1548.702,2,3,2,7,Others
MB-18085,45,7,1428.231,2,2,1,5,About to Sleep
MC-17275,77,8,2725.982,2,3,2,7,Others
MC-17425,400,5,4432.138,1,2,3,6,Average
MC-17575,28,8,1303.893,3,3,1,7,Potential Loyalist
MC-17590,52,6,2426.067,2,2,2,6,Average
MC-17605,113,8,2258.192,2,3,2,7,Others
MC-17635,190,4,795.154,1,1,1,3,Lost Customer
MC-17845,2,7,3805.714,3,2,3,8,Loyal
MC-18100,42,10,2218.98,3,3,2,8,Loyal
MC-18130,370,5,1581.9979999999998,1,2,2,5,About to Sleep
MD-17350,118,7,3766.382,2,2,3,7,Others
MD-17860,37,5,1204.91,3,2,1,6,Recent Customer
ME-17320,43,10,10663.728000000001,2,3,3,8,Loyal
ME-17725,29,8,1908.4532,3,3,2,8,Loyal
ME-18010,93,4,1256.944,2,1,1,4,About to Sleep
MF-17665,422,5,937.039,1,2,1,4,About to Sleep
MF-18250,8,5,1758.3,3,2,2,7,Potential Loyalist
MG-17650,30,7,3785.276,3,2,3,8,Loyal
MG-17680,93,4,2350.188,2,1,2,5,About to Sleep
MG-17695,556,3,1342.282,1,1,1,3,Lost Customer
MG-17875,117,5,1242.8329999999999,2,2,1,5,About to Sleep
MG-17890,100,9,776.384,2,3,1,6,Average
MG-18145,85,4,3061.543,2,1,2,5,About to Sleep
MG-18205,265,1,16.739,1,1,1,3,Lost Customer
MH-17290,120,6,2394.025,2,2,2,6,Average
MH-17440,377,4,400.016,1,1,1,3,Lost Customer
MH-17455,86,8,2456.1820000000002,2,3,2,7,Others
MH-17620,156,4,1252.8,1,1,1,3,Lost Customer
MH-17785,99,7,2203.7780000000002,2,2,2,6,Average
MH-18025,50,5,2984.948,2,2,2,6,Average
MH-18115,6,9,5503.093,3,3,3,9,Champion
MJ-17740,23,7,6320.746,3,2,3,8,Loyal
MK-17905,29,8,2302.368,3,3,2,8,Loyal
MK-18160,241,4,1031.602,1,1,1,3,Lost Customer
ML-17395,70,9,2722.843,2,3,2,7,Others
ML-17410,55,6,2921.5,2,2,2,6,Average
ML-17755,30,7,2071.9139999999998,3,2,2,7,Potential Loyalist
ML-18040,80,3,742.082,2,1,1,4,About to Sleep
ML-18265,101,2,162.232,2,1,1,4,About to Sleep
MM-17260,169,4,1314.023,1,1,1,3,Lost Customer
MM-17920,8,11,3794.0800000000004,3,3,3,9,Champion
MM-18055,62,8,2749.881,2,3,2,7,Others
MM-18280,86,9,775.414,2,3,1,6,Average
MN-17935,35,6,2477.946,3,2,2,7,Potential Loyalist
MO-17500,73,4,922.487,2,1,1,4,About to Sleep
MO-17800,105,8,1687.0269999999998,2,3,2,7,Others
MO-17950,181,2,154.288,1,1,1,3,Lost Customer
MP-17470,720,7,3206.132,1,2,3,6,Average
MP-17965,73,9,3983.6420000000003,2,3,3,8,Loyal
MP-18175,17,9,5087.92,3,3,3,9,Champion
MR-17545,126,4,639.178,1,1,1,3,Lost Customer
MS-17365,274,10,7443.6900000000005,1,3,3,7,Cannot Lose Them
MS-17530,435,4,475.65599999999995,1,1,1,3,Lost Customer
MS-17710,414,6,1613.402,1,2,2,5,About to Sleep
MS-17770,122,9,3144.678,1,3,3,7,Cannot Lose Them
MS-17830,453,4,370.348,1,1,1,3,Lost Customer
MS-17980,27,6,855.116,3,2,1,6,Recent Customer
MT-17815,50,6,2890.139,2,2,2,6,Average
MT-18070,204,4,1319.4498,1,1,1,3,Lost Customer
MV-17485,28,9,1560.05,3,3,2,8,Loyal
MV-18190,20,7,1734.574,3,2,2,7,Potential Loyalist
MW-18220,18,7,5341.900000000001,3,2,3,8,Loyal
MW-18235,45,2,5253.876,2,1,3,6,Average
MY-17380,30,7,2254.285,3,2,2,7,Potential Loyalist
MY-18295,72,11,4152.696,2,3,3,8,Loyal
MZ-17335,31,4,593.606,3,1,1,5,About to Sleep
MZ-17515,283,6,2564.906,1,2,2,5,About to Sleep
NB-18580,1166,2,273.87199999999996,1,1,1,3,Lost Customer
NB-18655,20,9,1972.599,3,3,2,8,Loyal
NC-18340,225,5,2461.404,1,2,2,5,About to Sleep
NC-18415,42,6,2218.9900000000002,3,2,2,7,Potential Loyalist
NC-18535,7,7,8241.739,3,2,3,8,Loyal
NC-18625,205,5,1821.742,1,2,2,5,About to Sleep
ND-18370,28,9,4326.139,3,3,3,9,Champion
ND-18460,184,6,2893.455,1,2,2,5,About to Sleep
NF-18385,80,7,8322.826,2,2,3,7,Others
NF-18475,526,4,377.16200000000003,1,1,1,3,Lost Customer
NF-18595,115,7,2031.472,2,2,2,6,Average
NG-18355,49,5,1869.58,2,2,2,6,Average
NG-18430,49,5,1395.9379999999999,2,2,1,5,About to Sleep
NH-18610,190,7,2673.29,1,2,2,5,About to Sleep
NK-18490,71,7,572.048,2,2,1,5,About to Sleep
NL-18310,59,4,1418.0900000000001,2,1,1,4,About to Sleep
NM-18445,161,7,6459.344,1,2,3,6,Average
NM-18520,245,10,2161.979,1,3,2,6,Average
NP-18325,26,6,5529.62,3,2,3,8,Loyal
NP-18670,59,5,3908.402,2,2,3,7,Others
NP-18685,407,6,1228.698,1,2,1,4,About to Sleep
NP-18700,139,7,7903.1825,1,2,3,6,Average
NR-18550,211,5,2367.277,1,2,2,5,About to Sleep
NS-18505,7,4,2575.863,3,1,2,6,Recent Customer
NS-18640,175,13,2964.823,1,3,2,6,Average
NW-18400,173,7,7234.014,1,2,3,6,Average
NZ-18565,86,9,2488.31,2,3,2,7,Others
ON-18715,411,9,1567.52,1,3,2,6,Average
OT-18730,66,5,3818.624,2,2,3,7,Others
PA-19060,104,6,729.408,2,2,1,5,About to Sleep
PB-18805,26,3,740.356,3,1,1,5,About to Sleep
PB-19105,58,4,688.324,2,1,1,4,About to Sleep
PB-19150,98,8,1456.95,2,3,2,7,Others
PB-19210,689,2,132.738,1,1,1,3,Lost Customer
PC-18745,3,4,1832.064,3,1,2,6,Recent Customer
PC-19000,883,2,1061.488,1,1,1,3,Lost Customer
PF-19120,836,4,9062.864,1,1,3,5,About to Sleep
PF-19165,197,6,2770.0,1,2,2,5,About to Sleep
PF-19225,115,5,2206.1279999999997,2,2,2,6,Average
PG-18820,37,13,3086.907,3,3,2,8,Loyal
PG-18895,58,9,1987.164,2,3,2,7,Others
PH-18790,71,1,729.648,2,1,1,4,About to Sleep
PJ-18835,40,8,1220.09,3,3,1,7,Potential Loyalist
PJ-19015,135,7,1824.2340000000002,1,2,2,5,About to Sleep
PK-18910,484,2,1441.152,1,1,1,3,Lost Customer
PK-19075,10,12,8646.934,3,3,3,9,Champion
PL-18925,16,5,239.481,3,2,1,6,Recent Customer
PM-18940,387,3,1405.402,1,1,1,3,Lost Customer
PM-19135,52,4,4115.662,2,1,3,6,Average
PN-18775,31,8,1467.152,3,3,2,8,Loyal
PO-18850,5,11,7473.8282,3,3,3,9,Champion
PO-18865,1,7,2493.214,3,2,2,7,Potential Loyalist
PO-19180,161,9,4893.043,1,3,3,7,Cannot Lose Them
PO-19195,87,5,1056.858,2,2,1,5,About to Sleep
PP-18955,98,10,7252.608,2,3,3,8,Loyal
PR-18880,37,5,1840.178,3,2,2,7,Potential Loyalist
PS-18760,108,6,2181.479,2,2,2,6,Average
PS-18970,70,8,1278.639,2,3,1,6,Average
PS-19045,237,7,6843.634,1,2,3,6,Average
PT-19090,72,4,160.572,2,1,1,4,About to Sleep
PV-18985,90,5,2876.046,2,2,2,6,Average
PW-19030,47,10,3454.916,2,3,3,8,Loyal
PW-19240,465,7,3922.4150000000004,1,2,3,6,Average
QJ-19255,26,9,6108.338,3,3,3,9,Champion
RA-19285,6,9,2617.906,3,3,2,8,Loyal
RA-19885,44,7,3832.314,2,2,3,7,Others
RA-19915,13,9,4793.543,3,3,3,9,Champion
RA-19945,62,5,1686.9225,2,2,2,6,Average
RB-19330,69,2,1008.1959999999999,2,1,1,4,About to Sleep
RB-19360,97,6,15117.339,2,2,3,7,Others
RB-19435,20,8,2663.0860000000002,3,3,2,8,Loyal
RB-19465,10,12,4715.466,3,3,3,9,Champion
RB-19570,26,5,528.546,3,2,1,6,Recent Customer
RB-19645,649,5,221.084,1,2,1,4,About to Sleep
RB-19705,55,4,2067.45,2,1,2,5,About to Sleep
RB-19795,33,8,5633.316000000001,3,3,3,9,Champion
RC-19825,370,6,966.409,1,2,1,4,About to Sleep
RC-19960,111,6,885.752,2,2,1,5,About to Sleep
RD-19480,73,8,4272.93,2,3,3,8,Loyal
RD-19585,181,10,2912.8940000000002,1,3,2,6,Average
RD-19660,115,5,2786.632,2,2,2,6,Average
RD-19720,22,10,1419.737,3,3,1,7,Potential Loyalist
RD-19810,15,8,1137.616,3,3,1,7,Potential Loyalist
RD-19900,115,9,3133.924,2,3,3,8,Loyal
RD-19930,43,4,970.9420000000001,2,1,1,4,About to Sleep
RE-19405,1098,1,48.36,1,1,1,3,Lost Customer
RE-19450,303,5,876.696,1,2,1,4,About to Sleep
RF-19345,391,8,3309.15,1,3,3,7,Cannot Lose Them
RF-19735,90,7,2341.2960000000003,2,2,2,6,Average
RF-19840,7,8,945.222,3,3,1,7,Potential Loyalist
RH-19495,33,5,3621.3759999999997,3,2,3,8,Loyal
RH-19510,468,6,6979.18,1,2,3,6,Average
RH-19555,520,2,740.382,1,1,1,3,Lost Customer
RH-19600,535,3,2085.7400000000002,1,1,2,4,About to Sleep
RK-19300,120,3,1460.192,2,1,2,5,About to Sleep
RL-19615,122,8,6234.91,1,3,3,7,Cannot Lose Them
RM-19375,346,6,1453.474,1,2,1,4,About to Sleep
RM-19675,7,5,5979.0960000000005,3,2,3,8,Loyal
RM-19750,300,1,98.35,1,1,1,3,Lost Customer
RO-19780,36,7,3815.478,3,2,3,8,Loyal
RP-19270,497,4,954.6452,1,1,1,3,Lost Customer
RP-19390,34,12,5153.084,3,3,3,9,Champion
RP-19855,29,8,2170.716,3,3,2,8,Loyal
RR-19315,20,2,615.932,3,1,1,5,About to Sleep
RR-19525,171,6,3302.2619999999997,1,2,3,6,Average
RS-19420,77,5,3221.29,2,2,3,7,Others
RS-19765,37,8,4159.7699999999995,3,3,3,9,Champion
RS-19870,20,2,22.328,3,1,1,5,About to Sleep
RW-19540,121,7,7397.401,2,3,3,8,Loyal
RW-19630,90,9,3279.746,2,3,3,8,Loyal
RW-19690,80,5,3495.646,2,2,3,7,Others
SA-20830,64,10,4767.3415,2,3,3,8,Loyal
SB-20170,202,3,1348.02,1,1,1,3,Lost Customer
SB-20185,189,6,6410.996,1,2,3,6,Average
SB-20290,48,7,8057.891,2,3,3,8,Loyal
SC-20020,782,5,3362.9636,1,2,3,6,Average
SC-20050,41,9,4624.572,3,3,3,9,Champion
SC-20095,350,9,14142.333999999999,1,3,3,7,Cannot Lose Them
SC-20230,150,4,4371.9580000000005,1,1,3,5,About to Sleep
SC-20260,188,8,3729.7929999999997,1,3,3,7,Cannot Lose Them
SC-20305,30,7,3979.065,3,3,3,9,Champion
SC-20380,31,9,5992.536,3,3,3,9,Champion
SC-20440,37,7,1874.998,3,3,2,8,Loyal
SC-20575,93,5,902.7280000000001,2,2,1,5,About to Sleep
SC-20680,127,6,1254.64,1,2,1,4,About to Sleep
SC-20695,90,10,2576.408,2,3,2,7,Others
SC-20725,188,11,5226.21,1,3,3,7,Cannot Lose Them
SC-20770,42,7,4492.657,3,3,3,9,Champion
SC-20800,31,4,279.25600000000003,3,1,1,5,About to Sleep
SC-20845,132,2,280.632,1,1,1,3,Lost Customer
SD-20485,201,9,6121.114,1,3,3,7,Cannot Lose Them
SE-20110,10,11,12209.438000000002,3,3,3,9,Champion
SF-20065,60,7,763.5459999999999,2,3,1,6,Average
SF-20200,60,9,3422.7859999999996,2,3,3,8,Loyal
SF-20965,49,9,3336.535,2,3,3,8,Loyal
SG-20080,9,3,3406.5809999999997,3,1,3,7,Potential Loyalist
SG-20470,184,8,1884.798,1,3,2,6,Average
SG-20605,109,6,3124.832,2,2,2,6,Average
SG-20890,227,3,47.946,1,1,1,3,Lost Customer
SH-19975,30,13,3406.8395,3,3,3,9,Champion
SH-20395,24,10,2180.718,3,3,2,8,Loyal
SH-20635,766,2,2096.392,1,1,2,4,About to Sleep
SJ-20125,96,12,3949.656,2,3,3,8,Loyal
SJ-20215,30,6,1341.036,3,2,1,6,Recent Customer
SJ-20500,254,5,1318.776,1,2,1,4,About to Sleep
SK-19990,9,3,883.409,3,1,1,5,About to Sleep
SL-20155,71,7,3053.012,2,3,2,7,Others
SM-20005,422,4,244.49399999999997,1,1,1,3,Lost Customer
SM-20320,80,5,25043.05,2,2,3,7,Others
SM-20905,607,1,1043.041,1,1,1,3,Lost Customer
SM-20950,26,12,5563.392,3,3,3,9,Champion
SN-20560,112,6,1860.418,2,2,2,6,Average
SN-20710,80,7,3127.9592,2,3,3,8,Loyal
SO-20335,30,6,2602.5755,3,2,2,7,Potential Loyalist
SP-20545,328,6,1306.086,1,2,1,4,About to Sleep
SP-20620,48,9,5440.319,2,3,3,8,Loyal
SP-20650,387,9,1872.4360000000001,1,3,2,6,Average
SP-20860,80,10,4282.94,2,3,3,8,Loyal
SP-20920,71,6,3990.689,2,2,3,7,Others
SR-20425,9,5,3233.481,3,2,3,8,Loyal
SR-20740,197,8,4345.8859999999995,1,3,3,7,Cannot Lose Them
SS-20140,16,8,1324.028,3,3,1,7,Potential Loyalist
SS-20410,111,6,3056.8070000000002,2,2,2,6,Average
SS-20515,492,3,613.4,1,1,1,3,Lost Customer
SS-20590,433,6,418.49,1,2,1,4,About to Sleep
SS-20875,121,5,964.636,2,2,1,5,About to Sleep
ST-20530,126,7,433.34000000000003,1,3,1,5,About to Sleep
SU-20665,21,7,2595.364,3,3,2,8,Loyal
SV-20365,102,10,11470.949999999999,2,3,3,8,Loyal
SV-20785,321,9,4105.305,1,3,3,7,Cannot Lose Them
SV-20815,77,4,1271.0900000000001,2,1,1,4,About to Sleep
SV-20935,3,8,1903.491,3,3,2,8,Loyal
SW-20245,82,7,1085.078,2,3,1,6,Average
SW-20275,31,6,1966.65,3,2,2,7,Potential Loyalist
SW-20350,163,3,1019.044,1,1,1,3,Lost Customer
SW-20455,163,7,2921.544,1,3,2,6,Average
SW-20755,535,2,758.6959999999999,1,1,1,3,Lost Customer
SZ-20035,36,11,3625.329,3,3,3,9,Champion
TA-21385,70,4,14595.62,2,1,3,6,Average
TB-21055,120,5,1467.881,2,2,2,6,Average
TB-21175,59,4,3589.296,2,1,3,6,Average
TB-21190,50,4,816.1740000000001,2,1,1,4,About to Sleep
TB-21250,350,7,1602.376,1,3,2,6,Average
TB-21280,584,6,2198.45,1,2,2,5,About to Sleep
TB-21355,147,5,834.328,1,2,1,4,About to Sleep
TB-21400,203,7,9133.99,1,3,3,7,Cannot Lose Them
TB-21520,108,9,4737.486,2,3,3,8,Loyal
TB-21595,286,5,1387.559,1,2,1,4,About to Sleep
TB-21625,31,9,2797.668,3,3,2,8,Loyal
TC-20980,400,5,19052.218,1,2,3,6,Average
TC-21145,107,1,1038.26,2,1,1,4,About to Sleep
TC-21295,28,8,4266.812,3,3,3,9,Champion
TC-21475,154,9,1244.976,1,3,1,5,About to Sleep
TC-21535,5,7,742.5580000000001,3,3,1,7,Potential Loyalist
TD-20995,38,9,1434.5480000000002,3,3,1,7,Potential Loyalist
TG-21310,338,5,3058.372,1,2,2,5,About to Sleep
TG-21640,115,4,2074.661,2,1,2,5,About to Sleep
TH-21100,345,5,2422.824,1,2,2,5,About to Sleep
TH-21115,59,4,2942.772,2,1,2,5,About to Sleep
TH-21235,118,8,1022.201,2,3,1,6,Average
TH-21550,73,7,4234.0960000000005,2,3,3,8,Loyal
TM-21010,104,8,2955.2259999999997,2,3,2,7,Others
TM-21490,131,3,1094.6779999999999,1,1,1,3,Lost Customer
TN-21040,91,7,3130.221,2,3,3,8,Loyal
TP-21130,9,9,4454.0560000000005,3,3,3,9,Champion
TP-21415,105,5,5329.0048,2,2,3,7,Others
TP-21565,351,4,1936.6399999999999,1,1,2,4,About to Sleep
TR-21325,194,5,675.9419999999999,1,2,1,4,About to Sleep
TS-21085,358,2,4.833,1,1,1,3,Lost Customer
TS-21160,505,6,2163.6240000000003,1,2,2,5,About to Sleep
TS-21205,199,7,5371.09,1,3,3,7,Cannot Lose Them
TS-21340,227,5,974.7819999999999,1,2,1,4,About to Sleep
TS-21370,37,6,11891.751,3,2,3,8,Loyal
TS-21430,173,5,2054.14,1,2,2,5,About to Sleep
TS-21505,12,6,2243.274,3,2,2,7,Potential Loyalist
TS-21610,56,7,2820.424,2,3,2,7,Others
TS-21655,239,5,3368.094,1,2,3,6,Average
TT-21070,32,7,4915.602,3,3,3,9,Champion
TT-21220,184,8,1427.0439999999999,1,3,1,5,About to Sleep
TT-21265,407,3,439.5,1,1,1,3,Lost Customer
TT-21460,13,7,5364.808,3,3,3,9,Champion
TW-21025,65,7,5278.826,2,3,3,8,Loyal
TZ-21580,36,4,1707.286,3,1,2,6,Recent Customer
VB-21745,55,6,2005.596,2,2,2,6,Average
VD-21670,582,6,6442.254,1,2,3,6,Average
VF-21715,14,5,847.944,3,2,1,6,Recent Customer
VG-21790,155,6,846.01,1,2,1,4,About to Sleep
VG-21805,287,5,427.372,1,2,1,4,About to Sleep
VM-21685,55,7,2454.866,2,3,2,7,Others
VM-21835,118,5,380.69,2,2,1,5,About to Sleep
VP-21730,31,3,993.9019999999999,3,1,1,5,About to Sleep
VP-21760,76,7,3360.526,2,3,3,8,Loyal
VS-21820,222,4,1055.981,1,1,1,3,Lost Customer
VT-21700,1001,2,1736.596,1,1,2,4,About to Sleep
VW-21775,29,10,6134.0380000000005,3,3,3,9,Champion
WB-21850,21,11,6160.102,3,3,3,9,Champion
XP-21865,44,11,2374.658,2,3,2,7,Others
YC-21895,5,5,5454.35,3,2,3,8,Loyal
YS-21880,10,8,6720.4439999999995,3,3,3,9,Champion
ZC-21910,55,13,8025.707,2,3,3,8,Loyal
ZD-21925,203,5,1493.944,1,2,2,5,About to Sleep
